NO ./assets/N.png

SO ./assets/S.png

WE ./assets/W.png

EA ./assets/E.png

F 155, 118, 83

C 6,118,141
                    
          111111111
 1111111111001100011
10010010010001010001
10110010000001010011
10010000000000001111
10110000000000000011
101100000000000111 1
10000000010000100011
10000000010000011101
10010000010000000001      
10010000010000000001      
10000000010000000001     
100000100100000000N1
 111111111111111111