11111111111111111111111111111111
10000010110001010001000010000001
10010010010001010000100000000001
10110010000001010010011000000001
10010000000000000011110000000001
10110001000000000000110000000001
10110000000000000000000000000001
10000000010000000000000000000001
10000000010000000000000001100001
10010000010000000000000001100001
10010000010000000000000001100001
10000000010000000000110000000001
10000010010000000010110000000001
11111111111111111111111111111111
