11111111111111111111111111111111
10000010110001010001000010000001
10010010010001010000100000000001
10110010000001010010011000000001
10010000000000000011110000000001
10110000000000000000110000000001
10110000000000000000000000000001
10000000010000000000000000000001
10000000010000000000000001100001
10010000010000000000000001100001
10010000010000000000000001100001
10000000010000000000110000000001
10000010010000000010110000000001
11111111111111111111111111111111


111
1N1
1


111
1N1	1 tab
11

1111
111N11
111 
   1


NO ./assets/N.png

SO ./assets/S.png

WE ./assets/W.png

EA ./assets/E.png

F 155, 118, 83




1111
111N11
1111
C 135, 206, 235



NO ./assets/N.png

SO ./assets/S.png

WE ./assets/W.png

EA ./assets/E.png

F 155, 118, 83




1111
111N11
C 135, 206, 235
1111


NO ./assets/N.png

SO ./assets/S.png

WE ./assets/W.png

EA ./assets/E.png


C 135, 206, 235
C 135, 206, 235

F 155, 118, 83


1111
111N11
1111

          111111111111 11111111
1111111111100110001001 100000011
1001001001000101000011 100000001
1011001000000101001001 100000001
100100000000N0000011111000000001
10110000000000000000110000000001
10110000000000000000000000000001
10000000010000000000000000000001
10000000010000000000000001100001
10010000010000000000000001100001         1111
10010000010000000000000001100001         100
10000000010000000000110000000001         1111
10000010010000000010110000000001
11111111111111111111 1111111111