              NO ./assets/Bricks.xpm
              SO ./assets/Bricks.xpm
       F 200,100,11
WE     ./assets/Bricks.xpm

C 12  ,11,  200
EA     ./assets/Bricks.xpm


     
         

        11 11 11 1 1 1 1 1 1
1111111111111111111111111
1000000000110000000000001
10110000011100000000000011111
11110010000000000000000000011111
111111111011000001110000000000001
100000000011000001110111111111111
11110111111111011100000010001
11110111111111011101010010001
10000000000000001100000010001
11111111111111111111111111111
11111111 1111111 111111111111 
11111111111111111111111111111
10000000000100001101010010001
1100000111010101111101111000111
11111111 1111111 111111111111
11110111 1110101 101111010001
11111111 1111111 111111111111
11111111 1111111 1111111 N111
11111111 1111111 111111111111