NO ./assets/N.png

SO ./assets/S.png

WE ./assets/W.png

EA ./assets/E.png

F 155, 118, 83

C , ,
                    
          111111111111111111111
 1111111111001100011 10000000011
10010010010001010001 10000000001
10110010000001010011 10000000001
10010000000000000011 11000000001
10110000000000000011 10000000001
101100000000000111 1 100000000001
10000000010000100011 10000000001
10000000010000011101 10001100001
10010000010000000001 10001100001        
10010000010000000001 10001100001        
10000000010000000001 10000000001       
100000100100000000N1 10000000001
 111111111111111111 11111111111