NO ./assets/N.png

SO ./assets/S.png

WE ./assets/W.png

EA ./assets/E.png

F 155, 118, 83
C 135, 206, 235

1111xx
111N11
110xxx 
xxx1xx
