NO ./assets/wall1.png
SO ./assets/wall2.png
WE ./assets/wall3.png
EA ./assets/wall4.png
F 155, 118, 83
C 135, 206, 235

11111111111111111111111111111111
10000010110001010001000010000001
10010010010001010000100000000001
101100100N0001010010011000000001
10010000000000000011110000000001
10110000000000000000110000000001
10110000000000000000000000000001
10000000010000000000000000000001
10000000010000000000000001100001
10010000010000000000000001100001
10010000010000000000000001100001
10000000010000000000110000000001
10000010010000000010110000000001
11111111111111111111111111111111
