NO ./assets/N.png

SO ./assets/S.png

WE ./assets/W.png

EA ./assets/E.png

F 155, 118, 83
C 135, 206, 235

11111111111111111111111111111111
10000010110001010001000010000001
100100101D1001010000100000000001
10110010000001010010011000000001
1001000N000010000011110000000001
10110000000000000000110000000001
10110000000000000000000000000001
10000000010000000000000000000001
10000000010000000000000001100001
10010000010000000000000001100001
10010000010000000000000001100001
1000000001001D100000110000000001
10000010010000000010110000000001
11111111111111111111111111111111
