NO ./assets/N.png

SO ./assets/S.png

WE ./assets/W.png

EA ./assets/E.png

F 155, 118, 83
C 135, 206, 235


11111111111111111111111111111111
11111111111000100010011100000011
1001001001000N000000111100000001
10110000000000000000000000000001
1001000001111D111111100000000001
10110000010000000000100000000001
10110000010000000000100000000001
100000000D000000000010000000000
10000000010000010000100001100001
10010000010000000000100001100001
10010000010000000000100001100001
100000000111111111D1100000000001
10000010000000000000000000000001
11111111111111111111111111111111