NO ./assets/N.png

SO ./assets/S.png

WE ./assets/W.png

EA ./assets/E.png

C 1, 2, 3

F 155, 118, 83


11111111111111111111111111111111
10000010000001010001000010000001
10010010111001010000100000000001
10110010000001010010011000000001
1001000N000100000111100000000001
10110000000000001000000000000001
1000011111111110D111111111000001
10000100010000001000000001000001
10000100000000000000000001100001
10010100010000001100000001100001
10010100000000000000000001100001
100001111111111111D1111111000001
10000010010000000000000000000001
10000000010000000010000000000001
1000000001D1000000D0000001100001
10010000010000000010000001100001
10010000010000000000000001100001
1000000001001D100000110000000001
10000010010000000010110000000001
11111111111111111111111111111111
