NO ./assets/N.png

SO ./assets/S.png

WE ./assets/W.png

EA ./assets/E.png

F 155, 118, 83
C 135, 206, 235


11111111111111111111111111111111
10000010000001010001000010000001
10010010111001010000100000000001
10110010000001010010011000000001
1001000N000010000011110000000001
10110000000000000000000000000001
1000011111111111D111111111000001
10000100010000000000000001000001
10000100000000000000000001100001
10010100010000001100000001100001
10010100000000000000000001100001
100001111111111111D1111111000001
10000010010000000000000000000001
11111111111111111111111111111111
