NO ./assets/N.png
SO ./assets/S.png
WE ./assets/W.png
EA ./assets/E.png
F 155, 118, 83
C 135, 206, 235

11111111111111111111111111111111
100001011S0010100010000100000001
10010000000001000000100000000001
10000000000000000010011000000001
10000000000000000011110000000001
10110000000000000000000000000001
10110000000000000000000000000001
10000000000000000000000000000001
10000000000000000000000000000001
10010000000000000000000001100001
10010000000000000000000001100001
10000000010000000000010000000001
10000010010000000010010000000001
11111111111111111111111111111111
