NO ./assets/N.png
SO ./assets/S.png
WE ./assets/W.png
EA ./assets/E.png
F 155, 118, 83
C 135, 206, 235

111111
101001
10D001
10N001
100001
111111