F 139,99,58
C 171,154,137

NO ./assets/N.png
SO ./assets/S.png
WE ./assets/W.png
EA ./assets/E.png


1111111111111111111
1001001001001001001
100100D001001001001
1001001001001001001
1001001000001001001
100000000S000000001
1000011D11111000001
1111000000000001111
1000000101D10000001
1111111111111111111
