NO ./assets/N.png

SO ./assets/S.png
C 6,118,141
F 5, 5 , 12



WE ./assets/W.png



EA ./assets/E.png


1111111111111111
1111100000000001
1000001D10000001
1000000000000001
1000000S00000001
1000000000000001
1111111111111111