NO ./assets/N.png
SO ./assets/S.png
WE ./assets/W.png
EA ./assets/E.png


C 53,41,34
F 45,33,27

111111111111111
111111000111111
111110000011111
1111000N0001111
111000000000111
110000000000111
1000011D1100D01
1100001D1000101
111000000000001
111100000001111
111110000011111
111111000111111
111111111111111
