NO ./assets/N.png

WE ./assets/W.png

F      17,    38,     64
EA ./assets/E.png


SO ./assets/S.png


C 218, 234, 235

1111111111111111111111111
10S0110000100000000000001
1000D0000000000011D111001
1000110000000000110001001
1000000000100000000001001
1111111111111111111111111
